64
64
23 24 25 25 26 25 26 27 27 26 25 26 25 25 28 29 23 24 25 25 26 25 26 27 27 26 25 26 25 25 28 29 23 24 25 25 26 25 26 27 27 26 25 26 25 25 28 29 23 24 25 25 26 25 26 27 27 26 25 26 25 25 28 29
43 44 45 45 46 45 46 47 47 46 45 46 45 45 48 49 43 44 45 45 46 45 46 47 47 46 45 46 45 45 48 49 43 44 45 45 46 45 46 47 47 46 45 46 45 45 48 49 43 44 45 45 46 45 46 47 47 46 45 46 45 45 48 49
32 33 1 1 1 1 1 1 1 1 1 1 1 1 30 31 32 33 1 1 1 1 1 1 1 1 1 1 1 1 30 31 32 33 20 20 20 1 1 1 1 1 1 20 20 20 30 31 32 33 21 21 21 1 1 1 1 1 1 21 21 21 30 31
32 33 1 1 1 1 1 1 1 1 1 1 1 1 30 31 32 33 1 1 1 1 1 1 1 1 1 1 1 1 30 31 32 33 20 20 1 1 1 1 1 1 1 20 20 20 30 31 32 33 21 21 21 1 1 1 1 1 1 21 21 21 30 31
52 53 1 1 1 1 1 1 1 1 1 1 1 1 50 51 52 53 1 1 1 1 1 1 1 1 1 1 1 1 50 51 52 53 20 1 1 1 1 1 1 1 1 20 20 20 50 51 52 53 20 20 20 20 2 2 2 2 20 20 20 20 50 51
32 33 1 1 1 1 1 1 1 1 1 1 1 1 30 31 32 33 1 1 1 1 1 1 1 1 1 1 1 1 30 31 32 33 1 1 1 1 20 1 1 20 1 1 1 1 30 31 32 33 2 2 2 2 2 2 2 2 2 2 2 2 30 31
52 53 1 1 1 1 1 1 1 1 1 1 1 1 50 51 52 53 1 1 1 1 1 1 1 1 1 1 1 1 50 51 52 53 1 1 1 1 1 20 20 1 1 1 1 1 50 51 52 53 2 2 2 2 2 2 2 2 2 2 2 2 50 51
72 73 1 1 1 1 1 1 1 1 1 1 1 1 100 100 100 100 1 1 1 1 1 1 1 1 1 1 1 1 100 100 100 100 1 1 1 1 1 20 20 1 1 1 1 1 100 100 2 2 2 2 2 2 2 2 2 2 2 2 2 2 70 71
72 73 1 1 1 1 1 1 1 1 1 1 1 1 100 100 100 100 1 1 1 1 1 1 1 1 1 1 1 1 100 100 100 100 1 1 1 1 1 20 20 1 1 1 1 1 100 100 2 2 2 2 2 2 2 2 2 2 2 2 2 2 70 71
52 53 1 1 1 1 1 1 1 1 1 1 1 1 50 51 52 53 1 1 1 1 1 1 1 1 1 1 1 1 50 51 52 53 1 1 1 1 1 20 20 1 1 1 1 1 50 51 52 53 2 2 2 2 2 2 2 2 2 2 2 2 50 51
32 33 1 1 1 1 1 1 1 1 1 1 1 1 30 31 32 33 1 1 1 1 1 1 1 1 1 1 1 1 30 31 32 33 1 1 1 1 20 1 1 20 1 1 1 1 30 31 32 33 2 2 2 2 2 2 2 2 2 2 2 2 30 31
52 53 1 1 1 1 1 1 1 1 1 1 1 1 50 51 52 53 1 1 1 1 1 1 1 1 1 1 1 1 50 51 52 53 20 1 1 1 1 1 1 1 1 20 20 20 50 51 52 53 20 2 2 2 2 2 2 2 2 2 2 20 50 51
32 33 1 1 1 1 1 1 1 1 1 1 1 1 30 31 32 33 20 1 1 1 20 20 20 20 1 1 1 20 30 31 32 33 20 20 1 1 1 1 1 1 1 20 20 20 30 31 32 33 20 20 2 2 2 2 2 2 2 2 20 20 30 31
32 33 1 1 1 1 1 1 1 1 1 1 1 1 30 31 32 33 20 1 1 20 20 20 20 20 20 1 1 20 30 31 32 33 20 20 20 1 1 1 1 1 1 20 20 20 30 31 32 33 20 20 20 2 2 2 2 2 2 20 20 20 30 31
63 64 65 65 66 65 66 67 67 66 65 66 65 65 68 69 63 64 65 65 66 65 66 67 67 66 65 66 65 65 68 69 63 64 65 65 66 65 66 100 100 66 65 66 65 65 68 69 63 64 65 65 66 65 66 67 67 66 65 66 65 65 68 69
83 84 85 85 86 85 86 87 87 86 85 86 85 85 88 89 83 84 85 85 86 85 86 87 87 86 85 86 85 85 88 89 83 84 85 85 86 85 86 100 100 86 85 86 85 85 88 89 83 84 85 85 86 85 86 87 87 86 85 86 85 85 88 89
23 24 25 25 26 25 26 27 27 26 25 26 25 25 28 29 23 24 25 25 26 25 26 27 27 26 25 26 25 25 28 29 23 24 25 25 26 25 26 100 100 26 25 26 25 25 28 29 23 24 25 25 26 25 26 27 27 26 25 26 25 25 28 29
43 44 45 45 46 45 46 47 47 46 45 46 45 45 48 49 43 44 45 45 46 45 46 47 47 46 45 46 45 45 48 49 43 44 45 45 46 45 46 100 100 46 45 46 45 45 48 49 43 44 45 45 46 45 46 47 47 46 45 46 45 45 48 49
32 33 40 40 40 22 40 40 40 22 40 22 22 40 30 31 32 33 20 3 3 3 1 1 1 1 3 3 3 20 30 31 32 33 3 1 3 1 1 3 3 1 1 3 1 3 30 31 32 33 1 1 1 1 1 1 1 1 1 1 1 1 30 31
32 33 40 22 22 22 22 40 22 22 40 40 22 40 30 31 32 33 3 3 1 1 20 1 1 20 1 1 3 3 30 31 32 33 1 3 1 1 3 1 1 3 1 1 3 1 30 31 32 33 1 1 1 1 20 1 1 20 1 1 1 1 30 31
52 53 40 22 22 22 22 40 22 22 40 22 40 40 50 51 52 53 3 1 1 1 1 1 1 1 1 1 1 3 50 51 52 53 3 1 3 1 1 3 3 1 1 3 1 3 50 51 52 53 1 1 20 1 1 20 20 1 1 20 1 1 50 51
32 33 40 40 22 22 22 40 22 22 40 22 40 40 30 31 32 33 3 1 1 1 20 1 1 20 1 1 1 3 30 31 32 33 1 1 1 1 3 1 1 3 1 1 1 1 30 31 32 33 1 1 1 20 20 20 20 20 20 1 1 1 30 31
52 53 40 22 22 22 22 40 22 22 40 22 22 40 50 51 52 53 20 20 20 20 1 1 1 1 20 20 20 20 50 51 52 53 1 1 1 3 1 1 1 1 3 1 1 1 50 51 52 53 1 1 1 1 20 20 20 20 1 1 1 1 50 51
72 73 40 22 22 22 40 40 40 22 40 22 22 40 70 71 72 73 3 3 3 3 3 3 3 3 3 3 3 3 70 71 72 73 1 3 1 1 1 1 1 1 1 1 3 1 100 100 100 100 1 1 1 1 1 1 1 1 1 1 1 1 70 71
72 73 22 22 22 22 22 22 22 22 22 22 22 22 70 71 72 73 3 3 3 3 3 3 3 3 3 3 3 3 70 71 72 73 1 3 1 1 1 1 1 1 1 1 3 1 100 100 100 100 1 1 1 1 1 1 1 1 1 1 1 1 70 71
52 53 40 40 40 40 40 40 40 40 40 40 40 40 50 51 52 53 20 20 20 20 1 1 1 1 20 20 20 20 50 51 52 53 1 1 1 3 1 1 1 1 3 1 1 1 50 51 52 53 1 1 1 1 1 1 1 1 1 1 1 1 50 51
32 33 40 40 40 40 40 40 40 40 40 40 40 40 30 31 32 33 3 1 1 1 20 1 1 20 1 1 1 3 30 31 32 33 1 1 1 1 3 1 1 3 1 1 1 1 30 31 32 33 1 1 1 1 1 1 1 1 1 1 1 1 30 31
52 53 40 40 40 40 40 40 40 40 40 40 40 40 50 51 52 53 3 1 1 1 1 1 1 1 1 1 1 3 50 51 52 53 3 1 3 1 1 3 3 1 1 3 1 3 50 51 52 53 1 1 1 1 1 1 1 1 1 1 1 1 50 51
32 33 40 40 40 40 40 40 40 40 40 40 40 40 30 31 32 33 3 3 1 1 20 1 1 20 1 1 3 3 30 31 32 33 1 3 1 1 3 1 1 3 1 1 3 1 30 31 32 33 20 1 1 1 1 1 1 1 1 1 1 20 30 31
32 33 40 40 40 40 40 40 40 40 40 40 40 40 30 31 32 33 20 3 3 3 1 1 1 1 3 3 3 20 30 31 32 33 3 1 3 1 1 3 3 1 1 3 1 3 30 31 32 33 20 20 1 1 1 1 1 1 1 1 20 20 30 31
63 64 65 65 66 65 66 67 67 66 65 66 65 65 68 69 63 64 65 65 66 65 66 100 100 66 65 66 65 65 68 69 63 64 65 65 66 65 66 100 100 66 65 66 65 65 68 69 63 64 65 65 66 65 66 67 67 66 65 66 65 65 68 69
83 84 85 85 86 85 86 87 87 86 85 86 85 85 88 89 83 84 85 85 86 85 86 100 100 86 85 86 85 85 88 89 83 84 85 85 86 85 86 100 100 86 85 86 85 85 88 89 83 84 85 85 86 85 86 87 87 86 85 86 85 85 88 89
23 24 25 25 26 25 26 27 27 26 25 26 25 25 28 29 23 24 25 25 26 25 26 100 100 26 25 26 25 25 28 29 23 24 25 25 26 25 26 100 100 26 25 26 25 25 28 29 23 24 25 25 26 25 26 27 27 26 25 26 25 25 28 29
43 44 45 45 46 45 46 47 47 46 45 46 45 45 48 49 43 44 45 45 46 45 46 100 100 46 45 46 45 45 48 49 43 44 45 45 46 45 46 100 100 46 45 46 45 45 48 49 43 44 45 45 46 45 46 47 47 46 45 46 45 45 48 49
32 33 20 20 20 2 2 2 2 2 2 20 20 20 30 31 32 33 20 20 20 1 1 1 1 1 1 20 20 20 30 31 32 33 3 3 3 3 3 1 1 3 3 3 3 3 30 31 32 33 21 21 21 1 1 3 3 1 1 21 21 21 30 31
32 33 20 20 2 2 2 2 2 2 2 2 20 20 30 31 32 33 1 1 1 1 1 1 1 1 1 1 1 1 30 31 32 33 3 1 1 1 1 3 3 1 1 1 1 3 30 31 32 33 21 21 21 1 1 3 3 1 1 21 21 21 30 31
52 53 20 2 2 2 2 2 2 2 2 2 2 20 50 51 52 53 20 20 1 1 1 1 1 1 1 1 20 20 50 51 52 53 3 1 1 1 1 3 3 1 1 1 1 3 50 51 52 53 20 20 20 20 2 2 2 2 20 20 20 20 50 51
32 33 2 2 2 2 2 2 2 2 2 2 2 2 30 31 32 33 1 1 1 1 1 1 1 1 1 1 1 1 30 31 32 33 3 1 1 1 1 3 3 1 1 1 1 1 30 31 32 33 2 2 2 2 2 2 2 2 2 2 2 2 30 31
52 53 2 2 2 2 2 2 2 2 2 2 2 2 50 51 52 53 20 1 1 1 1 1 1 1 1 1 1 20 50 51 52 53 3 1 1 1 1 3 3 1 1 1 1 3 50 51 52 53 2 2 2 2 2 2 2 2 2 2 2 2 50 51
72 73 2 2 2 2 2 2 2 2 2 2 2 2 2 2 100 100 1 1 1 1 1 1 1 1 1 1 1 1 100 100 100 100 1 3 3 3 3 3 3 3 3 3 3 1 100 100 100 100 2 2 2 2 2 2 2 2 2 2 2 2 70 71
72 73 2 2 2 2 2 2 2 2 2 2 2 2 2 2 100 100 1 1 1 1 1 1 1 1 1 1 1 1 100 100 100 100 1 3 3 3 3 3 3 3 3 3 3 1 100 100 100 100 2 2 2 2 2 2 2 2 2 2 2 2 70 71
52 53 2 2 2 2 2 2 2 2 2 2 2 2 50 51 52 53 1 1 3 3 3 3 3 3 3 3 1 1 50 51 52 53 3 1 1 1 1 3 3 1 1 1 1 3 50 51 52 53 2 2 2 2 2 2 2 2 2 2 2 2 50 51
32 33 2 2 2 2 2 2 2 2 2 2 2 2 30 31 32 33 3 3 1 1 1 1 1 1 1 1 3 3 30 31 32 33 3 1 1 1 1 3 3 1 1 1 1 3 30 31 32 33 2 2 2 2 2 2 2 2 2 2 2 2 30 31
52 53 20 20 20 20 2 2 2 2 20 20 20 20 50 51 52 53 20 3 1 1 1 3 3 1 1 1 3 20 50 51 52 53 3 1 1 1 1 3 3 1 1 1 1 3 50 51 52 53 20 20 20 20 2 2 2 2 20 20 20 20 50 51
32 33 21 21 21 1 1 1 1 1 1 21 21 21 30 31 32 33 20 3 1 1 3 1 1 3 1 1 3 20 30 31 32 33 3 1 1 1 1 3 3 1 1 1 1 3 30 31 32 33 21 21 21 1 1 3 3 1 1 21 21 21 30 31
32 33 21 21 21 1 1 1 1 1 1 21 21 21 30 31 32 33 20 3 3 3 1 1 1 1 3 3 3 20 30 31 32 33 3 3 3 3 3 1 1 3 3 3 3 3 30 31 32 33 21 21 21 1 1 3 3 1 1 21 21 21 30 31
63 64 65 65 66 65 66 67 67 66 65 66 65 65 68 69 63 64 65 65 66 65 66 100 100 66 65 66 65 65 68 69 63 64 65 65 66 65 66 67 67 66 65 66 65 65 68 69 63 64 65 65 66 65 66 67 67 66 65 66 65 65 68 69
83 84 85 85 86 85 86 87 87 86 85 86 85 85 88 89 83 84 85 85 86 85 86 100 100 86 85 86 85 85 88 89 83 84 85 85 86 85 86 87 87 86 85 86 85 85 88 89 83 84 85 85 86 85 86 87 87 86 85 86 85 85 88 89
23 24 25 25 26 25 26 27 27 26 25 26 25 25 28 29 23 24 25 25 26 25 26 100 100 26 25 26 25 25 28 29 23 24 25 25 26 25 26 27 27 26 25 26 25 25 28 29 23 24 25 25 26 25 26 27 27 26 25 26 25 25 28 29
43 44 45 45 46 45 46 47 47 46 45 46 45 45 48 49 43 44 45 45 46 45 46 100 100 46 45 46 45 45 48 49 43 44 45 45 46 45 46 47 47 46 45 46 45 45 48 49 43 44 45 45 46 45 46 47 47 46 45 46 45 45 48 49
32 33 1 1 1 1 1 1 1 1 1 1 1 1 30 31 32 33 3 1 1 1 1 1 1 1 1 1 1 3 30 31 32 33 20 20 22 22 22 22 22 22 22 22 20 20 30 31 32 33 22 40 22 40 22 40 22 40 22 40 22 40 30 31
32 33 1 1 1 1 1 1 1 1 1 1 1 1 30 31 32 33 1 3 1 1 1 1 1 1 1 1 3 1 30 31 32 33 20 20 20 20 20 20 20 20 20 20 20 20 30 31 32 33 22 40 22 40 22 40 22 40 22 40 22 40 30 31
52 53 1 1 1 1 1 1 1 1 1 1 1 1 50 51 52 53 1 1 3 1 1 1 1 1 1 3 1 1 50 51 52 53 40 20 1 1 1 1 1 1 1 1 20 40 50 51 52 53 22 40 22 40 22 40 22 40 22 40 22 40 50 51
32 33 1 1 1 1 1 1 1 1 1 1 1 1 30 31 32 33 1 1 1 3 1 1 1 1 3 1 1 1 30 31 32 33 20 1 1 1 1 1 1 1 1 1 1 20 30 31 32 33 22 40 22 40 22 40 22 40 22 40 22 40 30 31
52 53 1 1 1 1 1 1 1 1 1 1 1 1 50 51 52 53 3 1 3 1 3 1 1 3 1 3 1 3 50 51 52 53 1 1 1 1 1 1 1 1 1 1 1 1 50 51 52 53 22 40 22 40 22 40 22 40 22 40 22 40 50 51
72 73 1 1 1 1 1 1 1 1 1 1 1 1 70 71 72 73 1 3 1 1 1 3 3 1 1 1 3 1 100 100 100 100 1 1 1 1 1 1 1 1 1 1 1 1 70 71 72 73 22 40 22 40 22 40 22 40 22 40 22 40 70 71
72 73 1 1 1 1 1 1 1 1 1 1 1 1 70 71 72 73 1 3 1 1 1 3 3 1 1 1 3 1 100 100 100 100 1 1 1 1 1 1 1 1 1 1 1 1 70 71 72 73 22 40 22 40 22 40 22 40 22 40 22 40 70 71
52 53 1 1 1 1 1 1 1 1 1 1 1 1 50 51 52 53 3 1 3 1 3 1 1 3 1 3 1 3 50 51 52 53 1 1 1 1 1 1 1 1 1 1 1 1 50 51 52 53 22 40 22 40 22 40 22 40 22 40 22 40 50 51
32 33 22 22 22 22 22 22 22 22 22 22 22 22 30 31 32 33 1 1 1 3 1 1 1 1 3 1 1 1 30 31 32 33 20 1 1 1 1 1 1 1 1 1 1 20 30 31 32 33 22 40 22 40 22 40 22 40 22 40 22 40 30 31
52 53 22 22 22 22 22 22 22 22 22 22 22 22 50 51 52 53 1 1 3 1 1 1 1 1 1 3 1 1 50 51 52 53 40 20 1 1 1 1 1 1 1 1 20 40 50 51 52 53 22 40 22 40 22 40 22 40 22 40 22 40 50 51
32 33 22 22 22 22 22 22 22 22 22 22 22 22 30 31 32 33 1 3 1 1 20 1 1 20 1 1 3 1 30 31 32 33 20 20 20 20 20 20 20 20 20 20 20 20 30 31 32 33 22 40 22 40 22 40 22 40 22 40 22 40 30 31
32 33 22 22 22 22 22 22 22 22 22 22 22 22 30 31 32 33 3 1 20 20 20 20 20 20 20 20 1 3 30 31 32 33 20 20 22 22 22 22 22 22 22 22 20 20 30 31 32 33 22 40 22 40 22 40 22 40 22 40 22 40 30 31
63 64 65 65 66 65 66 67 67 66 65 66 65 65 68 69 63 64 65 65 66 65 66 67 67 66 65 66 65 65 68 69 63 64 65 65 66 65 66 67 67 66 65 66 65 65 68 69 63 64 65 65 66 65 66 67 67 66 65 66 65 65 68 69
83 84 85 85 86 85 86 87 87 86 85 86 85 85 88 89 83 84 85 85 86 85 86 87 87 86 85 86 85 85 88 89 83 84 85 85 86 85 86 87 87 86 85 86 85 85 88 89 83 84 85 85 86 85 86 87 87 86 85 86 85 85 88 89