16
16
23 24 25 25 26 25 26 27 27 26 25 26 25 25 28 29
43 44 45 45 46 45 46 47 47 46 45 46 45 45 48 49
32 33 21 21 20 1 1 1 1 1 21 20 20 20 30 31
32 33 1 1 20 1 1 1 1 1 1 21 20 20 30 31
52 53 1 1 1 1 1 1 1 1 1 1 21 20 50 51
32 33 1 1 1 1 1 1 1 1 1 1 1 1 30 31
52 53 1 1 1 1 1 1 1 1 1 1 1 1 50 51
72 73 1 1 1 1 1 1 1 1 1 1 1 1 70 71
72 73 1 1 1 1 1 1 1 1 1 1 1 1 70 71
52 53 1 1 1 1 1 1 1 1 1 1 1 1 50 51
32 33 1 1 1 1 1 1 1 1 1 1 1 1 30 31
52 53 1 1 1 1 1 1 1 1 1 1 21 20 50 51
32 33 1 1 20 1 1 1 1 1 1 21 20 20 30 31
32 33 21 21 20 1 1 1 1 1 21 20 20 20 30 31
63 64 65 65 66 65 66 67 67 66 65 66 65 65 68 69
83 84 85 85 85 86 85 86 87 87 85 86 85 85 88 89
