80
80
0 0 0 0 0 0 0 0 0 0 0 0 0 0 0 0 0 0 0 0 0 0 0 0 0 0 0 0 0 0 0 0 0 0 0 0 0 0 0 0 0 0 0 0 0 0 0 0 0 0 0 0 0 0 0 0 0 0 0 0 0 0 0 0 0 0 0 0 0 0 0 0 0 0 0 0 0 0 0 0
0 0 0 0 0 0 0 0 0 0 0 0 0 0 0 0 0 0 0 0 0 0 0 0 0 0 0 0 0 0 0 0 0 0 0 0 0 0 0 0 0 0 0 0 0 0 0 0 0 0 0 0 0 0 0 0 0 0 0 0 0 0 0 0 0 0 0 0 0 0 0 0 0 0 0 0 0 0 0 0
0 0 0 0 0 0 0 0 0 0 0 0 0 0 0 0 0 0 0 0 0 0 0 0 0 0 0 0 0 0 0 0 0 0 0 0 0 0 0 0 0 0 0 0 0 0 0 0 0 0 0 0 0 0 0 0 0 0 0 0 0 0 0 0 0 0 0 0 0 0 0 0 0 0 0 0 0 0 0 0
0 0 0 0 0 0 0 0 0 0 0 0 0 0 0 0 0 0 0 0 0 0 0 0 0 0 0 0 0 0 0 0 0 0 0 0 0 0 0 0 0 0 0 0 0 0 0 0 0 0 0 0 0 0 0 0 0 0 0 0 0 0 0 0 0 0 0 0 0 0 0 0 0 0 0 0 0 0 0 0
0 0 0 0 0 0 0 0 0 0 0 0 0 0 0 0 0 0 0 0 0 0 0 0 0 0 0 0 0 0 0 0 0 0 0 0 0 0 0 0 0 0 0 0 0 0 0 0 0 0 0 0 0 0 0 0 0 0 0 0 0 0 0 0 0 0 0 0 0 0 0 0 0 0 0 0 0 0 0 0
0 0 0 0 0 0 0 0 0 0 0 0 0 0 0 0 0 0 0 0 0 0 0 0 0 0 0 0 0 0 0 0 0 0 0 0 0 0 0 0 0 0 0 0 0 0 0 0 0 0 0 0 0 0 0 0 0 0 0 0 0 0 0 0 0 0 0 0 0 0 0 0 0 0 0 0 0 0 0 0
0 0 0 0 0 0 0 0 0 0 0 0 0 0 0 0 0 0 0 0 0 0 0 0 0 0 0 0 0 0 0 0 0 0 0 0 0 0 0 0 0 0 0 0 0 0 0 0 0 0 0 0 0 0 0 0 0 0 0 0 0 0 0 0 0 0 0 0 0 0 0 0 0 0 0 0 0 0 0 0
0 0 0 0 0 0 0 0 0 0 0 0 0 0 0 0 0 0 0 0 0 0 0 0 0 0 0 0 0 0 0 0 0 0 0 0 0 0 0 0 0 0 0 0 0 0 0 0 0 0 0 0 0 0 0 0 0 0 0 0 0 0 0 0 0 0 0 0 0 0 0 0 0 0 0 0 0 0 0 0
0 0 0 0 0 0 0 0 23 24 25 25 26 25 26 27 27 26 25 26 25 25 28 29 23 24 25 25 26 25 26 27 27 26 25 26 25 25 28 29 23 24 25 25 26 25 26 27 27 26 25 26 25 25 28 29 23 24 25 25 26 25 26 27 27 26 25 26 25 25 28 29 0 0 0 0 0 0 0 0
0 0 0 0 0 0 0 0 43 44 45 45 46 45 46 47 47 46 45 46 45 45 48 49 43 44 45 45 46 45 46 47 47 46 45 46 45 45 48 49 43 44 45 45 46 45 46 47 47 46 45 46 45 45 48 49 43 44 45 45 46 45 46 47 47 46 45 46 45 45 48 49 0 0 0 0 0 0 0 0
0 0 0 0 0 0 0 0 32 33 1 1 1 1 1 1 1 1 1 1 1 1 30 31 32 33 1 1 1 1 1 1 1 1 1 1 1 1 30 31 32 33 1 1 1 1 1 1 1 1 1 1 1 1 30 31 32 33 1 1 1 1 1 1 1 1 1 1 1 1 30 31 0 0 0 0 0 0 0 0
0 0 0 0 0 0 0 0 32 33 1 1 1 1 1 1 1 1 1 1 1 1 30 31 32 33 1 1 1 1 1 1 1 1 1 1 1 1 30 31 32 33 1 1 1 1 1 1 1 1 1 1 1 1 30 31 32 33 1 1 1 1 1 1 1 1 1 1 1 1 30 31 0 0 0 0 0 0 0 0
0 0 0 0 0 0 0 0 52 53 1 1 1 1 1 1 1 1 1 1 1 1 50 51 52 53 1 1 1 1 1 1 1 1 1 1 1 1 50 51 52 53 1 1 1 1 1 1 1 1 1 1 1 1 50 51 52 53 1 1 1 1 1 1 1 1 1 1 1 1 50 51 0 0 0 0 0 0 0 0
0 0 0 0 0 0 0 0 32 33 1 1 1 1 1 1 1 1 1 1 1 1 30 31 32 33 1 1 1 1 1 1 1 1 1 1 1 1 30 31 32 33 1 1 1 1 1 1 1 1 1 1 1 1 30 31 32 33 1 1 1 1 1 1 1 1 1 1 1 1 30 31 0 0 0 0 0 0 0 0
0 0 0 0 0 0 0 0 52 53 1 1 1 1 1 1 1 1 1 1 1 1 50 51 52 53 1 1 1 1 1 1 1 1 1 1 1 1 50 51 52 53 1 1 1 1 1 1 1 1 1 1 1 1 50 51 52 53 1 1 1 1 1 1 1 1 1 1 1 1 50 51 0 0 0 0 0 0 0 0
0 0 0 0 0 0 0 0 72 73 1 1 1 1 1 1 1 1 1 1 1 1 1 1 1 1 1 1 1 1 1 1 1 1 1 1 1 1 1 1 1 1 1 1 1 1 1 1 1 1 1 1 1 1 1 1 1 1 1 1 1 1 1 1 1 1 1 1 1 1 70 71 0 0 0 0 0 0 0 0
0 0 0 0 0 0 0 0 72 73 1 1 1 1 1 1 1 1 1 1 1 1 1 1 1 1 1 1 1 1 1 1 1 1 1 1 1 1 1 1 1 1 1 1 1 1 1 1 1 1 1 1 1 1 1 1 1 1 1 1 1 1 1 1 1 1 1 1 1 1 70 71 0 0 0 0 0 0 0 0
0 0 0 0 0 0 0 0 52 53 1 1 1 1 1 1 1 1 1 1 1 1 50 51 52 53 1 1 1 1 1 1 1 1 1 1 1 1 50 51 52 53 1 1 1 1 1 1 1 1 1 1 1 1 50 51 52 53 1 1 1 1 1 1 1 1 1 1 1 1 50 51 0 0 0 0 0 0 0 0
0 0 0 0 0 0 0 0 32 33 1 1 1 1 1 1 1 1 1 1 1 1 30 31 32 33 1 1 1 1 1 1 1 1 1 1 1 1 30 31 32 33 1 1 1 1 1 1 1 1 1 1 1 1 30 31 32 33 1 1 1 1 1 1 1 1 1 1 1 1 30 31 0 0 0 0 0 0 0 0
0 0 0 0 0 0 0 0 52 53 1 1 1 1 1 1 1 1 1 1 1 1 50 51 52 53 1 1 1 1 1 1 1 1 1 1 1 1 50 51 52 53 1 1 1 1 1 1 1 1 1 1 1 1 50 51 52 53 1 1 1 1 1 1 1 1 1 1 1 1 50 51 0 0 0 0 0 0 0 0
0 0 0 0 0 0 0 0 32 33 1 1 1 1 1 1 1 1 1 1 1 1 30 31 32 33 1 1 1 1 1 1 1 1 1 1 1 1 30 31 32 33 1 1 1 1 1 1 1 1 1 1 1 1 30 31 32 33 1 1 1 1 1 1 1 1 1 1 1 1 30 31 0 0 0 0 0 0 0 0
0 0 0 0 0 0 0 0 32 33 1 1 1 1 1 1 1 1 1 1 1 1 30 31 32 33 1 1 1 1 1 1 1 1 1 1 1 1 30 31 32 33 1 1 1 1 1 1 1 1 1 1 1 1 30 31 32 33 1 1 1 1 1 1 1 1 1 1 1 1 30 31 0 0 0 0 0 0 0 0
0 0 0 0 0 0 0 0 63 64 65 65 66 65 66 1 1 66 65 66 65 65 68 69 63 64 65 65 66 65 66 1 1 66 65 66 65 65 68 69 63 64 65 65 66 65 66 1 1 66 65 66 65 65 68 69 63 64 65 65 66 65 66 1 1 66 65 66 65 65 68 69 0 0 0 0 0 0 0 0
0 0 0 0 0 0 0 0 83 84 85 85 86 85 86 1 1 86 85 86 85 85 88 89 83 84 85 85 86 85 86 1 1 86 85 86 85 85 88 89 83 84 85 85 86 85 86 1 1 86 85 86 85 85 88 89 83 84 85 85 86 85 86 1 1 86 85 86 85 85 88 89 0 0 0 0 0 0 0 0
0 0 0 0 0 0 0 0 23 24 25 25 26 25 26 27 27 26 25 26 25 25 28 29 23 24 25 25 26 25 26 27 27 26 25 26 25 25 28 29 23 24 25 25 26 25 26 27 27 26 25 26 25 25 28 29 23 24 25 25 26 25 26 27 27 26 25 26 25 25 28 29 0 0 0 0 0 0 0 0
0 0 0 0 0 0 0 0 43 44 45 45 46 45 46 47 47 46 45 46 45 45 48 49 43 44 45 45 46 45 46 47 47 46 45 46 45 45 48 49 43 44 45 45 46 45 46 47 47 46 45 46 45 45 48 49 43 44 45 45 46 45 46 47 47 46 45 46 45 45 48 49 0 0 0 0 0 0 0 0
0 0 0 0 0 0 0 0 32 33 1 1 1 1 1 1 1 1 1 1 1 1 30 31 32 33 1 1 1 1 1 1 1 1 1 1 1 1 30 31 32 33 1 1 1 1 1 1 1 1 1 1 1 1 30 31 32 33 1 1 1 1 1 1 1 1 1 1 1 1 30 31 0 0 0 0 0 0 0 0
0 0 0 0 0 0 0 0 32 33 1 1 1 1 1 1 1 1 1 1 1 1 30 31 32 33 1 1 1 1 1 1 1 1 1 1 1 1 30 31 32 33 1 1 1 1 1 1 1 1 1 1 1 1 30 31 32 33 1 1 1 1 1 1 1 1 1 1 1 1 30 31 0 0 0 0 0 0 0 0
0 0 0 0 0 0 0 0 52 53 1 1 1 1 1 1 1 1 1 1 1 1 50 51 52 53 1 1 1 1 1 1 1 1 1 1 1 1 50 51 52 53 1 1 1 1 1 1 1 1 1 1 1 1 50 51 52 53 1 1 1 1 1 1 1 1 1 1 1 1 50 51 0 0 0 0 0 0 0 0
0 0 0 0 0 0 0 0 32 33 1 1 1 1 1 1 1 1 1 1 1 1 30 31 32 33 1 1 1 1 1 1 1 1 1 1 1 1 30 31 32 33 1 1 1 1 1 1 1 1 1 1 1 1 30 31 32 33 1 1 1 1 1 1 1 1 1 1 1 1 30 31 0 0 0 0 0 0 0 0
0 0 0 0 0 0 0 0 52 53 1 1 1 1 1 1 1 1 1 1 1 1 50 51 52 53 1 1 1 1 1 1 1 1 1 1 1 1 50 51 52 53 1 1 1 1 1 1 1 1 1 1 1 1 50 51 52 53 1 1 1 1 1 1 1 1 1 1 1 1 50 51 0 0 0 0 0 0 0 0
0 0 0 0 0 0 0 0 72 73 1 1 1 1 1 1 1 1 1 1 1 1 1 1 1 1 1 1 1 1 1 1 1 1 1 1 1 1 1 1 1 1 1 1 1 1 1 1 1 1 1 1 1 1 1 1 1 1 1 1 1 1 1 1 1 1 1 1 1 1 70 71 0 0 0 0 0 0 0 0
0 0 0 0 0 0 0 0 72 73 1 1 1 1 1 1 1 1 1 1 1 1 1 1 1 1 1 1 1 1 1 1 1 1 1 1 1 1 1 1 1 1 1 1 1 1 1 1 1 1 1 1 1 1 1 1 1 1 1 1 1 1 1 1 1 1 1 1 1 1 70 71 0 0 0 0 0 0 0 0
0 0 0 0 0 0 0 0 52 53 1 1 1 1 1 1 1 1 1 1 1 1 50 51 52 53 1 1 1 1 1 1 1 1 1 1 1 1 50 51 52 53 1 1 1 1 1 1 1 1 1 1 1 1 50 51 52 53 1 1 1 1 1 1 1 1 1 1 1 1 50 51 0 0 0 0 0 0 0 0
0 0 0 0 0 0 0 0 32 33 1 1 1 1 1 1 1 1 1 1 1 1 30 31 32 33 1 1 1 1 1 1 1 1 1 1 1 1 30 31 32 33 1 1 1 1 1 1 1 1 1 1 1 1 30 31 32 33 1 1 1 1 1 1 1 1 1 1 1 1 30 31 0 0 0 0 0 0 0 0
0 0 0 0 0 0 0 0 52 53 1 1 1 1 1 1 1 1 1 1 1 1 50 51 52 53 1 1 1 1 1 1 1 1 1 1 1 1 50 51 52 53 1 1 1 1 1 1 1 1 1 1 1 1 50 51 52 53 1 1 1 1 1 1 1 1 1 1 1 1 50 51 0 0 0 0 0 0 0 0
0 0 0 0 0 0 0 0 32 33 1 1 1 1 1 1 1 1 1 1 1 1 30 31 32 33 1 1 1 1 1 1 1 1 1 1 1 1 30 31 32 33 1 1 1 1 1 1 1 1 1 1 1 1 30 31 32 33 1 1 1 1 1 1 1 1 1 1 1 1 30 31 0 0 0 0 0 0 0 0
0 0 0 0 0 0 0 0 32 33 1 1 1 1 1 1 1 1 1 1 1 1 30 31 32 33 1 1 1 1 1 1 1 1 1 1 1 1 30 31 32 33 1 1 1 1 1 1 1 1 1 1 1 1 30 31 32 33 1 1 1 1 1 1 1 1 1 1 1 1 30 31 0 0 0 0 0 0 0 0
0 0 0 0 0 0 0 0 63 64 65 65 66 65 66 1 1 66 65 66 65 65 68 69 63 64 65 65 66 65 66 1 1 66 65 66 65 65 68 69 63 64 65 65 66 65 66 1 1 66 65 66 65 65 68 69 63 64 65 65 66 65 66 1 1 66 65 66 65 65 68 69 0 0 0 0 0 0 0 0
0 0 0 0 0 0 0 0 83 84 85 85 86 85 86 1 1 86 85 86 85 85 88 89 83 84 85 85 86 85 86 1 1 86 85 86 85 85 88 89 83 84 85 85 86 85 86 1 1 86 85 86 85 85 88 89 83 84 85 85 86 85 86 1 1 86 85 86 85 85 88 89 0 0 0 0 0 0 0 0
0 0 0 0 0 0 0 0 23 24 25 25 26 25 26 27 27 26 25 26 25 25 28 29 23 24 25 25 26 25 26 27 27 26 25 26 25 25 28 29 23 24 25 25 26 25 26 27 27 26 25 26 25 25 28 29 23 24 25 25 26 25 26 27 27 26 25 26 25 25 28 29 0 0 0 0 0 0 0 0
0 0 0 0 0 0 0 0 43 44 45 45 46 45 46 47 47 46 45 46 45 45 48 49 43 44 45 45 46 45 46 47 47 46 45 46 45 45 48 49 43 44 45 45 46 45 46 47 47 46 45 46 45 45 48 49 43 44 45 45 46 45 46 47 47 46 45 46 45 45 48 49 0 0 0 0 0 0 0 0
0 0 0 0 0 0 0 0 32 33 1 1 1 1 1 1 1 1 1 1 1 1 30 31 32 33 1 1 1 1 1 1 1 1 1 1 1 1 30 31 32 33 1 1 1 1 1 1 1 1 1 1 1 1 30 31 32 33 1 1 1 1 1 1 1 1 1 1 1 1 30 31 0 0 0 0 0 0 0 0
0 0 0 0 0 0 0 0 32 33 1 1 1 1 1 1 1 1 1 1 1 1 30 31 32 33 1 1 1 1 1 1 1 1 1 1 1 1 30 31 32 33 1 1 1 1 1 1 1 1 1 1 1 1 30 31 32 33 1 1 1 1 1 1 1 1 1 1 1 1 30 31 0 0 0 0 0 0 0 0
0 0 0 0 0 0 0 0 52 53 1 1 1 1 1 1 1 1 1 1 1 1 50 51 52 53 1 1 1 1 1 1 1 1 1 1 1 1 50 51 52 53 1 1 1 1 1 1 1 1 1 1 1 1 50 51 52 53 1 1 1 1 1 1 1 1 1 1 1 1 50 51 0 0 0 0 0 0 0 0
0 0 0 0 0 0 0 0 32 33 1 1 1 1 1 1 1 1 1 1 1 1 30 31 32 33 1 1 1 1 1 1 1 1 1 1 1 1 30 31 32 33 1 1 1 1 1 1 1 1 1 1 1 1 30 31 32 33 1 1 1 1 1 1 1 1 1 1 1 1 30 31 0 0 0 0 0 0 0 0
0 0 0 0 0 0 0 0 52 53 1 1 1 1 1 1 1 1 1 1 1 1 50 51 52 53 1 1 1 1 1 1 1 1 1 1 1 1 50 51 52 53 1 1 1 1 1 1 1 1 1 1 1 1 50 51 52 53 1 1 1 1 1 1 1 1 1 1 1 1 50 51 0 0 0 0 0 0 0 0
0 0 0 0 0 0 0 0 72 73 1 1 1 1 1 1 1 1 1 1 1 1 1 1 1 1 1 1 1 1 1 1 1 1 1 1 1 1 1 1 1 1 1 1 1 1 1 1 1 1 1 1 1 1 1 1 1 1 1 1 1 1 1 1 1 1 1 1 1 1 70 71 0 0 0 0 0 0 0 0
0 0 0 0 0 0 0 0 72 73 1 1 1 1 1 1 1 1 1 1 1 1 1 1 1 1 1 1 1 1 1 1 1 1 1 1 1 1 1 1 1 1 1 1 1 1 1 1 1 1 1 1 1 1 1 1 1 1 1 1 1 1 1 1 1 1 1 1 1 1 70 71 0 0 0 0 0 0 0 0
0 0 0 0 0 0 0 0 52 53 1 1 1 1 1 1 1 1 1 1 1 1 50 51 52 53 1 1 1 1 1 1 1 1 1 1 1 1 50 51 52 53 1 1 1 1 1 1 1 1 1 1 1 1 50 51 52 53 1 1 1 1 1 1 1 1 1 1 1 1 50 51 0 0 0 0 0 0 0 0
0 0 0 0 0 0 0 0 32 33 1 1 1 1 1 1 1 1 1 1 1 1 30 31 32 33 1 1 1 1 1 1 1 1 1 1 1 1 30 31 32 33 1 1 1 1 1 1 1 1 1 1 1 1 30 31 32 33 1 1 1 1 1 1 1 1 1 1 1 1 30 31 0 0 0 0 0 0 0 0
0 0 0 0 0 0 0 0 52 53 1 1 1 1 1 1 1 1 1 1 1 1 50 51 52 53 1 1 1 1 1 1 1 1 1 1 1 1 50 51 52 53 1 1 1 1 1 1 1 1 1 1 1 1 50 51 52 53 1 1 1 1 1 1 1 1 1 1 1 1 50 51 0 0 0 0 0 0 0 0
0 0 0 0 0 0 0 0 32 33 1 1 1 1 1 1 1 1 1 1 1 1 30 31 32 33 1 1 1 1 1 1 1 1 1 1 1 1 30 31 32 33 1 1 1 1 1 1 1 1 1 1 1 1 30 31 32 33 1 1 1 1 1 1 1 1 1 1 1 1 30 31 0 0 0 0 0 0 0 0
0 0 0 0 0 0 0 0 32 33 1 1 1 1 1 1 1 1 1 1 1 1 30 31 32 33 1 1 1 1 1 1 1 1 1 1 1 1 30 31 32 33 1 1 1 1 1 1 1 1 1 1 1 1 30 31 32 33 1 1 1 1 1 1 1 1 1 1 1 1 30 31 0 0 0 0 0 0 0 0
0 0 0 0 0 0 0 0 63 64 65 65 66 65 66 1 1 66 65 66 65 65 68 69 63 64 65 65 66 65 66 1 1 66 65 66 65 65 68 69 63 64 65 65 66 65 66 1 1 66 65 66 65 65 68 69 63 64 65 65 66 65 66 1 1 66 65 66 65 65 68 69 0 0 0 0 0 0 0 0
0 0 0 0 0 0 0 0 83 84 85 85 86 85 86 1 1 86 85 86 85 85 88 89 83 84 85 85 86 85 86 1 1 86 85 86 85 85 88 89 83 84 85 85 86 85 86 1 1 86 85 86 85 85 88 89 83 84 85 85 86 85 86 1 1 86 85 86 85 85 88 89 0 0 0 0 0 0 0 0
0 0 0 0 0 0 0 0 23 24 25 25 26 25 26 27 27 26 25 26 25 25 28 29 23 24 25 25 26 25 26 27 27 26 25 26 25 25 28 29 23 24 25 25 26 25 26 27 27 26 25 26 25 25 28 29 23 24 25 25 26 25 26 27 27 26 25 26 25 25 28 29 0 0 0 0 0 0 0 0
0 0 0 0 0 0 0 0 43 44 45 45 46 45 46 47 47 46 45 46 45 45 48 49 43 44 45 45 46 45 46 47 47 46 45 46 45 45 48 49 43 44 45 45 46 45 46 47 47 46 45 46 45 45 48 49 43 44 45 45 46 45 46 47 47 46 45 46 45 45 48 49 0 0 0 0 0 0 0 0
0 0 0 0 0 0 0 0 32 33 1 1 1 1 1 1 1 1 1 1 1 1 30 31 32 33 1 1 1 1 1 1 1 1 1 1 1 1 30 31 32 33 1 1 1 1 1 1 1 1 1 1 1 1 30 31 32 33 1 1 1 1 1 1 1 1 1 1 1 1 30 31 0 0 0 0 0 0 0 0
0 0 0 0 0 0 0 0 32 33 1 1 1 1 1 1 1 1 1 1 1 1 30 31 32 33 1 1 1 1 1 1 1 1 1 1 1 1 30 31 32 33 1 1 1 1 1 1 1 1 1 1 1 1 30 31 32 33 1 1 1 1 1 1 1 1 1 1 1 1 30 31 0 0 0 0 0 0 0 0
0 0 0 0 0 0 0 0 52 53 1 1 1 1 1 1 1 1 1 1 1 1 50 51 52 53 1 1 1 1 1 1 1 1 1 1 1 1 50 51 52 53 1 1 1 1 1 1 1 1 1 1 1 1 50 51 52 53 1 1 1 1 1 1 1 1 1 1 1 1 50 51 0 0 0 0 0 0 0 0
0 0 0 0 0 0 0 0 32 33 1 1 1 1 1 1 1 1 1 1 1 1 30 31 32 33 1 1 1 1 1 1 1 1 1 1 1 1 30 31 32 33 1 1 1 1 1 1 1 1 1 1 1 1 30 31 32 33 1 1 1 1 1 1 1 1 1 1 1 1 30 31 0 0 0 0 0 0 0 0
0 0 0 0 0 0 0 0 52 53 1 1 1 1 1 1 1 1 1 1 1 1 50 51 52 53 1 1 1 1 1 1 1 1 1 1 1 1 50 51 52 53 1 1 1 1 1 1 1 1 1 1 1 1 50 51 52 53 1 1 1 1 1 1 1 1 1 1 1 1 50 51 0 0 0 0 0 0 0 0
0 0 0 0 0 0 0 0 72 73 1 1 1 1 1 1 1 1 1 1 1 1 1 1 1 1 1 1 1 1 1 1 1 1 1 1 1 1 1 1 1 1 1 1 1 1 1 1 1 1 1 1 1 1 1 1 1 1 1 1 1 1 1 1 1 1 1 1 1 1 70 71 0 0 0 0 0 0 0 0
0 0 0 0 0 0 0 0 72 73 1 1 1 1 1 1 1 1 1 1 1 1 1 1 1 1 1 1 1 1 1 1 1 1 1 1 1 1 1 1 1 1 1 1 1 1 1 1 1 1 1 1 1 1 1 1 1 1 1 1 1 1 1 1 1 1 1 1 1 1 70 71 0 0 0 0 0 0 0 0
0 0 0 0 0 0 0 0 52 53 1 1 1 1 1 1 1 1 1 1 1 1 50 51 52 53 1 1 1 1 1 1 1 1 1 1 1 1 50 51 52 53 1 1 1 1 1 1 1 1 1 1 1 1 50 51 52 53 1 1 1 1 1 1 1 1 1 1 1 1 50 51 0 0 0 0 0 0 0 0
0 0 0 0 0 0 0 0 32 33 1 1 1 1 1 1 1 1 1 1 1 1 30 31 32 33 1 1 1 1 1 1 1 1 1 1 1 1 30 31 32 33 1 1 1 1 1 1 1 1 1 1 1 1 30 31 32 33 1 1 1 1 1 1 1 1 1 1 1 1 30 31 0 0 0 0 0 0 0 0
0 0 0 0 0 0 0 0 52 53 1 1 1 1 1 1 1 1 1 1 1 1 50 51 52 53 1 1 1 1 1 1 1 1 1 1 1 1 50 51 52 53 1 1 1 1 1 1 1 1 1 1 1 1 50 51 52 53 1 1 1 1 1 1 1 1 1 1 1 1 50 51 0 0 0 0 0 0 0 0
0 0 0 0 0 0 0 0 32 33 1 1 1 1 1 1 1 1 1 1 1 1 30 31 32 33 1 1 1 1 1 1 1 1 1 1 1 1 30 31 32 33 1 1 1 1 1 1 1 1 1 1 1 1 30 31 32 33 1 1 1 1 1 1 1 1 1 1 1 1 30 31 0 0 0 0 0 0 0 0
0 0 0 0 0 0 0 0 32 33 1 1 1 1 1 1 1 1 1 1 1 1 30 31 32 33 1 1 1 1 1 1 1 1 1 1 1 1 30 31 32 33 1 1 1 1 1 1 1 1 1 1 1 1 30 31 32 33 1 1 1 1 1 1 1 1 1 1 1 1 30 31 0 0 0 0 0 0 0 0
0 0 0 0 0 0 0 0 63 64 65 65 66 65 66 1 1 66 65 66 65 65 68 69 63 64 65 65 66 65 66 1 1 66 65 66 65 65 68 69 63 64 65 65 66 65 66 1 1 66 65 66 65 65 68 69 63 64 65 65 66 65 66 67 67 66 65 66 65 65 68 69 0 0 0 0 0 0 0 0
0 0 0 0 0 0 0 0 83 84 85 85 86 85 86 1 1 86 85 86 85 85 88 89 83 84 85 85 86 85 86 1 1 86 85 86 85 85 88 89 83 84 85 85 86 85 86 1 1 86 85 86 85 85 88 89 83 84 85 85 86 85 86 87 87 86 85 86 85 85 88 89 0 0 0 0 0 0 0 0
0 0 0 0 0 0 0 0 0 0 0 0 0 0 0 0 0 0 0 0 0 0 0 0 0 0 0 0 0 0 0 0 0 0 0 0 0 0 0 0 0 0 0 0 0 0 0 0 0 0 0 0 0 0 0 0 0 0 0 0 0 0 0 0 0 0 0 0 0 0 0 0 0 0 0 0 0 0 0 0
0 0 0 0 0 0 0 0 0 0 0 0 0 0 0 0 0 0 0 0 0 0 0 0 0 0 0 0 0 0 0 0 0 0 0 0 0 0 0 0 0 0 0 0 0 0 0 0 0 0 0 0 0 0 0 0 0 0 0 0 0 0 0 0 0 0 0 0 0 0 0 0 0 0 0 0 0 0 0 0
0 0 0 0 0 0 0 0 0 0 0 0 0 0 0 0 0 0 0 0 0 0 0 0 0 0 0 0 0 0 0 0 0 0 0 0 0 0 0 0 0 0 0 0 0 0 0 0 0 0 0 0 0 0 0 0 0 0 0 0 0 0 0 0 0 0 0 0 0 0 0 0 0 0 0 0 0 0 0 0
0 0 0 0 0 0 0 0 0 0 0 0 0 0 0 0 0 0 0 0 0 0 0 0 0 0 0 0 0 0 0 0 0 0 0 0 0 0 0 0 0 0 0 0 0 0 0 0 0 0 0 0 0 0 0 0 0 0 0 0 0 0 0 0 0 0 0 0 0 0 0 0 0 0 0 0 0 0 0 0
0 0 0 0 0 0 0 0 0 0 0 0 0 0 0 0 0 0 0 0 0 0 0 0 0 0 0 0 0 0 0 0 0 0 0 0 0 0 0 0 0 0 0 0 0 0 0 0 0 0 0 0 0 0 0 0 0 0 0 0 0 0 0 0 0 0 0 0 0 0 0 0 0 0 0 0 0 0 0 0
0 0 0 0 0 0 0 0 0 0 0 0 0 0 0 0 0 0 0 0 0 0 0 0 0 0 0 0 0 0 0 0 0 0 0 0 0 0 0 0 0 0 0 0 0 0 0 0 0 0 0 0 0 0 0 0 0 0 0 0 0 0 0 0 0 0 0 0 0 0 0 0 0 0 0 0 0 0 0 0
0 0 0 0 0 0 0 0 0 0 0 0 0 0 0 0 0 0 0 0 0 0 0 0 0 0 0 0 0 0 0 0 0 0 0 0 0 0 0 0 0 0 0 0 0 0 0 0 0 0 0 0 0 0 0 0 0 0 0 0 0 0 0 0 0 0 0 0 0 0 0 0 0 0 0 0 0 0 0 0
0 0 0 0 0 0 0 0 0 0 0 0 0 0 0 0 0 0 0 0 0 0 0 0 0 0 0 0 0 0 0 0 0 0 0 0 0 0 0 0 0 0 0 0 0 0 0 0 0 0 0 0 0 0 0 0 0 0 0 0 0 0 0 0 0 0 0 0 0 0 0 0 0 0 0 0 0 0 0 0